Team,Gms,Tot Pts,Pts/G,RushYds,RYds/G,PassYds,PYds/G,TotYds,Yds/G
Denver Broncos,16,606,37.9,1873,117.1,5444,340.2,7317,457.3
Philadelphia Eagles,16,442,27.6,2566,160.4,4110,256.9,6676,417.2
Green Bay Packers,16,417,26.1,2136,133.5,4268,266.8,6404,400.2
New Orleans Saints,16,414,25.9,1473,92.1,4918,307.4,6391,399.4
San Diego Chargers,16,396,24.8,1965,122.8,4328,270.5,6293,393.3
Detroit Lions,16,395,24.7,1792,112.0,4482,280.1,6274,392.1
New England Patriots,16,444,27.8,2065,129.1,4087,255.4,6152,384.5
Chicago Bears,16,445,27.8,1828,114.2,4281,267.6,6109,381.8
Washington Redskins,16,334,20.9,2164,135.2,3751,234.4,5915,369.7
Cincinnati Bengals,16,430,26.9,1755,109.7,4136,258.5,5891,368.2
Houston Texans,16,276,17.2,1743,108.9,3813,238.3,5556,347.2
Arizona Cardinals,16,379,23.7,1540,96.2,4002,250.1,5542,346.4
Minnesota Vikings,16,391,24.4,2081,130.1,3427,214.2,5508,344.2
Atlanta Falcons,16,353,22.1,1247,77.9,4243,265.2,5490,343.1
Indianapolis Colts,16,391,24.4,1743,108.9,3725,232.8,5468,341.8
Dallas Cowboys,16,439,27.4,1504,94.0,3954,247.1,5458,341.1
Cleveland Browns,16,308,19.2,1383,86.4,4047,252.9,5430,339.4
Seattle Seahawks,16,417,26.1,2188,136.8,3236,202.2,5424,339.0
Buffalo Bills,16,339,21.2,2307,144.2,3103,193.9,5410,338.1
Pittsburgh Steelers,16,379,23.7,1383,86.4,4017,251.1,5400,337.5
Kansas City Chiefs,16,430,26.9,2056,128.5,3340,208.8,5396,337.2
Tennessee Titans,16,362,22.6,1894,118.4,3496,218.5,5390,336.9
Oakland Raiders,16,322,20.1,2000,125.0,3340,208.8,5340,333.8
San Francisco 49ers,16,406,25.4,2201,137.6,2979,186.2,5180,323.8
New York Jets,16,290,18.1,2158,134.9,2932,183.2,5090,318.1
Carolina Panthers,16,366,22.9,2026,126.6,3043,190.2,5069,316.8
Miami Dolphins,16,317,19.8,1440,90.0,3567,222.9,5007,312.9
New York Giants,16,294,18.4,1332,83.2,3588,224.2,4920,307.5
Baltimore Ravens,16,320,20.0,1328,83.0,3590,224.4,4918,307.4
St. Louis Rams,16,348,21.8,1752,109.5,3125,195.3,4877,304.8
Jacksonville Jaguars,16,247,15.4,1260,78.8,3441,215.1,4701,293.8
Tampa Bay Buccaneers,16,288,18.0,1612,100.8,2820,176.2,4432,277.0